1111111111111111111111111111111111
1E00000F0000000C00000C000000000001
1010010100100000101001000000010101
1010010010101010P01001000F00010101
100000000C00C00000000000F0000000C1
1111111111111111111111111111111111
